10010011100
00001000100
00010000100
00000000100
01000000100
00000000100
00000000100
000000000010
