030000000000
020222002220
020202002020
020202002024
020202022000
020202020000
022202220000
000000000000
